OOOOOOOOOOOOOOOOOOOOOOOOOOOOOKOOOSOOOOOOEOOOOOOOOOOOOSOOOSOOOKOOOOO
OOOOOOOOOOOOOOOPOPOPOPOPOPOPOPOPPPPPOPPOPOOOOOOOOOOOPPPPPPPOPPPOOOO
OOOOOOOSOOOOOOOOOSKSOOOOOOOOOOOOOOOOOOOOOOOOOKSOOOPOOOOOOOOOOOOOOOO
OOOOOOOPOPOOOPOOOPPPOOOOOOOOOOOOOOOOOOOOOOOOPPPPPOOOOOOOOOOOOOOOOOO
OOOOOOOKOOOOSKOOOKOOOSKSKSOOOSOOOOKOOOOKOOOOOOOOOSOOOOOKOOOOOOEOOOO
PPPPPPPPPPPPPPPPPPPPPPPPPPPPPPPPPPPPPPPPPPPOPOPOPPPPPPPPPPPPPPPPPPP
